#########################################
#            ###                         
# ##########v### ###### ############## ##
#                #                  ## ##
#### ################## #################
#                                       #
#### ####################################
#                                       #
########## ##############################
########## ############################ #       
                                        #
#########################################
